FFFFFFFFFF
FFWWFFFFFF
FSFFFFFFFF
FFFFFFFFFF
FFFFFFWFFF
FFFFFBFFFF
FFWFFFFFFF
FFFFFFFFFF
FFFFFFWFFF
FFFWFFFFFF