WFFFWFFFFF
FFWFWFFFFF
FWBFWFFFFF
FFFWWFFFFF
FFWFFFFFFW
FWBFWFFFFF
FFFWWFFFFS
FFWFWFFFFF
FWBFWFFFFF
FFFWWFFFFF